15 9
1 1 1 1 1 1 1 1 1 1 1 1 1 1 1
1 51 1 11 1 31 1 1 1 41 1 21 1 51 1
0 0 0 0 0 0 0 0 0 0 0 0 0 0 0
2 2 2 0 2 2 2 0 2 2 2 0 2 2 2
2 100 2 0 2 101 2 0 2 102 2 0 2 103 2
2 2 2 0 2 2 2 0 2 2 2 0 2 2 2
0 0 0 0 0 0 0 0 0 0 0 0 0 0 0
1 51 1 11 1 31 1 1 1 41 1 21 1 51 1
1 1 1 1 1 1 1 1 1 1 1 1 1 1 1
