15 9
1 1 1 1 1 1 1 1 1 1 1 1 1 1 1
1 1 11 1 3 3 3 1 3 3 3 1 21 1 1
1 1 41 1 3 100 1 1 1 101 3 1 31 1 1
1 1 1 1 3 3 3 1 3 3 3 1 1 1 1
1 1 51 1 1 1 3 1 3 1 1 1 51 1 1
1 1 1 1 3 3 3 1 3 3 3 1 1 1 1
1 1 31 1 3 102 1 1 1 103 3 1 41 1 1
1 1 21 1 3 3 3 1 3 3 3 1 11 1 1
1 1 1 1 1 1 1 1 1 1 1 1 1 1 1
