15 9
2 2 2 2 2 2 2 2 2 2 2 2 2 2 2
2 31 2 51 2 11 2 51 2 41 2 51 2 21 2
2 2 2 2 2 2 2 2 2 2 2 2 2 2 2
2 51 2 100 2 4 2 102 2 4 2 4 2 51 2
2 2 2 2 2 2 2 2 2 2 2 2 2 2 2
2 51 2 4 2 101 2 4 2 103 2 4 2 51 2
2 2 2 2 2 2 2 2 2 2 2 2 2 2 2
2 31 2 51 2 11 2 51 2 41 2 51 2 21 2
2 2 2 2 2 2 2 2 2 2 2 2 2 2 2
