15 7
1 1 1 1 1 1 1 1 1 1 1 1 1 1 1
1 1 1 1 31 1 1 1 1 1 31 1 1 1 1
1 1 1 1 100 31 1 1 1 1 102 31 1 1 1
1 1 31 31 31 31 31 1 31 31 31 31 31 1 1
1 1 1 1 101 31 1 1 1 1 103 31 1 1 1
1 1 1 1 31 1 1 1 1 1 31 1 1 1 1
1 1 1 1 1 1 1 1 1 1 1 1 1 1 1
